Do you know your U.S. Government History? You're on a school field trip to our nation's historical cities. You need to talk to the important people in history in which they will give you important documents to win the game!

Government Tour
An Interactive Fiction by Lindsay Palsgrove
Release 1 / Serial number 141022 / Inform 7 build 6L02 (I6/v6.33 lib 6/12N) SD

Independence Hall
This is the centerpiece of Independence National Historical Park in Philadelphia, Pennsylvania. It is known primarily as the location where both the Declaration of Independence and the United States Constitution were debated and adopted. Also North is Philadelphia

You can see wooden door, Phil, Barack Obama and Thomas Jefferson here.

>talk to Phil
What? I don't know anything about Independence Hall! What is happening? D:

I beg your pardon?

* * *

>talk to Phill
You can't see any such thing.

* * *

>i
You are carrying nothing.

>x me
As good-looking as ever.

>talk to Barack Obama
I am the President of the United States! Why are you talking to me?

>talk to Thomas Jefferson
I am a American Founding Father, the principal author of the Declaration of Independence, and the third President of the United States. Are you looking for something?

>talk to Phil
What? I don't know anything about Independence Hall! What is happening? D:

>idk
That's not a verb I recognise.

>open wooden door
It seems to be locked.

>unlock door
What do you want to unlock wooden door with?

>with declaration of independence
You can't see any such thing.

>talk to Thomas Jefferson
I am a American Founding Father, the principal author of the Declaration of Independence, and the third President of the United States. Are you looking for something?

>ask Thomas Jefferson about Declaration of Independence
Oh yes! You can have it! :)

>i
You are carrying:
  Declaration of Independence

>unlock door with declaration of idependence
I only understood you as far as wanting to unlock wooden door with Declaration of Independence.

>unlock door with declaration of independence
You unlock wooden door.

>open door
You open wooden door.

>n
Philadelphia Convention
You can see wooden door, Black door, Bill of Rights, Caleb, George Bush and James Madison here.

>talk to Caleb
Hi? Where am I?

>talk to George Bush
I am the former President of the United States! Im getting payed to be here. -__-

>talk to James Madison
I am a American statesman, political theorist and the fourth President of the United States. I am hailed as the Father of the Constitution for drafting of the United States Constitution and author of the United States Bill of Rights. Are you looking for something?

>talk to James Madison about Bill of Rights
I only understood you as far as wanting to talk to James Madison.

>talk to James Madison about Consitution
I only understood you as far as wanting to talk to James Madison.

>open door
Which do you mean, wooden door or Black door?

>open black door
You open Black door.

>s
Independence Hall
The centerpiece of Independence National Historical Park in Philadelphia, Pennsylvania. It is known primarily as the location where both the Declaration of Independence and the United States Constitution were debated and adopted.

You can see wooden door, Phil, Barack Obama and Thomas Jefferson here.

>n
Philadelphia Convention
You can see wooden door, Black door, Bill of Rights, Caleb, George Bush and James Madison here.

>n
You can't go that way.

>e
Branches of Government
You can see Black door here.

* * *

>i
You are carrying nothing.

>talk to thomas
I am a American Founding Father, the principal author of the Declaration of Independence, and the third President of the United States. Are you looking for something?

>i
You are carrying nothing.

>ask thomas about declaration
There is no reply.

>ask thomas about declaration of independence
Oh yes! You can have it! :)

>i
You are carrying:
  Declaration of Independence

>n
(first opening Wooden door)
It seems to be locked.

>unlock door with declaration of independence
That doesn't seem to fit the lock.

* * *

>talk to Obama
I am the President of the United States! Why are you talking to me?

>because i love you
That's not a verb I recognise.

>talk to Phil
What? I don't know anything about Independence Hall! What is happening? D:

>talk to thomas
I am a American Founding Father, the principal author of the Declaration of Independence, and the third President of the United States. Are you looking for something?

>ask thomas about declaration
There is no reply.

>ask thomas about declaration independence
There is no reply.

>ask thomas about declaration of independence
Oh yes! You can have it! :)

* * *

>talk thomas
I didn't understand that sentence.

>talk to thomas
I am a American Founding Father, the principal author of the Declaration of Independence, and the third President of the United States. Are you looking for something?

>ask thomas about declaration of independence
Oh yes! You can have it! :)

* * *

>i
You are carrying:
  Declaration of Independence

>n
(first opening wooden door)
It seems to be locked.

>unlock door
(with Declaration of Independence)
You unlock wooden door.

>open
(Declaration of Independence)
It isn't something you can open.

>open door
You open wooden door.

>n
Philadelphia Convention
You can see wooden door and Bill of Rights here.

* * *

>talk to Thomas Jefferson
I am a American Founding Father, the principal author of the Declaration of Independence, and the third President of the United States. Are you looking for something?

>ask about Declaration of Independence
You can't see any such thing.

>ask Thomas Jefferson about Declaration of Independence
Oh yes! You can have it! :)

* * *

>i
You are carrying:
  Declaration of Independence

>n
Philadelphia Convention
You can see Wooden door and Bill of Rights here.

>undo
Independence Hall
[Previous turn undone.]

>undo
Independence Hall
[Previous turn undone.]

>i
You are carrying:
  Declaration of Independence

>undo
Independence Hall
[Previous turn undone.]

>i
You are carrying nothing.

* * *

>talk to Thomas
I am a American Founding Father, the principal author of the Declaration of Independence , and the third President of the United States. Are you looking for something?

* * *

>open door
It seems to be locked.

>unlock door
What do you want to unlock Wooden door with?

>i
You are carrying nothing.

* * *

>talk to thomas
I am a American Founding Father, the principal author of the Declaration of Independence, and the third President of the United States. Are you looking for something?

>talk to thomas about declaration of Independence
I only understood you as far as wanting to talk to Thomas Jefferson.

>ask thomas about declaration of independence
Oh yes! You can have it! :)

>open door
It seems to be locked.

>unlock door
(with Declaration of Independence)
You unlock wooden door.

>n
(first opening wooden door)

Philadelphia
The largest city in the Commonwealth of Pennsylvania, the fifth-most-populous city in the United States, and the core of the sixth-largest metropolitan area in the country. White house is East .

You can see wooden door, Black door, Bill of Rights, Caleb, George Bush and James Madison here.

>talk to james madison
I am a American statesman, political theorist and the fourth President of the United States. I am hailed as the Father of the Constitution for drafting of the United States Constitution and author of the United States Bill of Rights. Are you looking for something?

>ask james about bill of rights
You want that? Okay here!

>e
(first opening Black door)

White House
You can see Black door, Cabinet (closed), Ana and Bill Clinton here.

>open cabinet
You open Cabinet, revealing Three Branches of Government.

>take three branches government
Taken.

    *** What a inspiring historic trip! We learned so much about our country's government! SUPER FUN~! The End ***

Would you like to RESTART, RESTORE a saved game, QUIT or UNDO the last command?

>i
You are carrying:
  Three Branches of Government
  Bill of Rights
  Declaration of Independence

* * *

>unlock door
(with Declaration of Independence)
You unlock wooden door.

>n
(first opening wooden door)

Philadelphia Convention
You can see wooden door and Bill of Rights here.

* * *

>ask thomas about declaration of independence
Oh yes! You can have it! :)

>n
(first opening wooden door)
It seems to be locked.

>unlock door with declaration of independence
You unlock wooden door.

>n
(first opening wooden door)

Philadelphia
The largest city in the Commonwealth of Pennsylvania, the fifth-most-populous city in the United States, and the core of the sixth-largest metropolitan area in the country. White house is East .

You can see wooden door, Black door, Bill of Rights, Caleb, George Bush and James Madison here.

>talk james
I didn't understand that sentence.

>talk to james
I am a American statesman, political theorist and the fourth President of the United States. I am hailed as the Father of the Constitution for drafting of the United States Constitution and author of the United States Bill of Rights. Are you looking for something?

>ask james about bill rights
There is no reply.

>ask james about bill of rights
You want that? Okay here!

>e
(first opening Black door)

White House
The official residence and principal workplace of the President of the United States. It has been the residence of every U.S. president since John Adams in 1800.

You can see Black door, Cabinet (closed), Ana and Bill Clinton here.

>x cabinet
You see nothing special about Cabinet.

>x ana
You don't really like her so lets not talk to her.

>talk to ana
    *** This chick is crazy! She made a big scene in the White House and now you got kicked out! Sorry bro :l. ***

Would you like to RESTART, RESTORE a saved game, QUIT or UNDO the last command?

>undo
White House
[Previous turn undone.]

>x bill clinton
Wow he is still alive?

>talk to bill clintion
You can't see any such thing.

>talk to bill
(Bill of Rights)

>talk to bill clinton
Damn this place looks so different! Its like a whole new place!

>open cabinet
You open Cabinet, revealing Three Branches of Government.

>take three branches of government
Taken.

    *** What a inspiring historic trip! We learned so much about our country's government! SUPER FUN~! The End ***

Would you like to RESTART, RESTORE a saved game, QUIT or UNDO the last command?

* * *

>ask thomas about declaration
There is no reply.

>ask thomas about independence
There is no reply.

>ask thomas about declaration of independence
Oh yes! You can have it! :)

>restart
Are you sure you want to restart?

>y
Do you know your U.S. Government History? You're on a school field trip to our nation's historical cities. You need to talk to the important people in history in which they will give you important documents to win the game!

Government Tour
An Interactive Fiction by Lindsay Palsgrove
Release 1 / Serial number 141022 / Inform 7 build 6L02 (I6/v6.33 lib 6/12N) SD

Independence Hall
This is the centerpiece of Independence National Historical Park in Philadelphia, Pennsylvania. It is known primarily as the location where both the Declaration of Independence and the United States Constitution were debated and adopted. Also North is Philadelphia

You can see wooden door, Phil, Barack Obama and Thomas Jefferson here.

>ask thomas about declaration
There is no reply.

* * *

>talk to Barack
I am the President of the United States! Why are you talking to me?

* * *

>tak to Barack Obama
That's not a verb I recognise.

>talk to Barack Obama
I am the President of the United States! Why are you talking to me?

>talk to Thomas
I am a American Founding Father, the principal author of the Declaration of Independence , and the third President of the United States. Are you looking for something?

* * *

>n
(first opening wooden door)
It seems to be locked.

>i
You are carrying nothing.

>n
(first opening Wooden door)
It seems to be locked.

* * *

>i
You are carrying nothing.

>x
What do you want to examine?

>xme
You can't see any such thing.

>x me
As good-looking as ever.

* * *

>n
(first opening wooden door)
It seems to be locked.

>s
Philadelphia Convention
You can see Wooden door and Bill of Rights here.

>take to thomas
You can't see any such thing.

>n
Independence Hall
The centerpiece of Independence National Historical Park in Philadelphia, Pennsylvania. It is known primarily as the location where both the Declaration of Independence and the United States Constitution were debated and adopted.

You can see Wooden door, Phil, Barack Obama and Thomas Jefferson here.

>talk to thomas
I am a American Founding Father, the principal author of the Declaration of Independence, and the third President of the United States. Are you looking for something?

* * *

>ask thomas about declaration of independence
Oh yes! You can have it! :)

>n
(first opening Wooden door)
It seems to be locked.

>take declaration of independence
You already have that.

>n
(first opening Wooden door)
It seems to be locked.

* * *

>n
(first opening wooden door)
It seems to be locked.

>talk to thomas
I am a American Founding Father, the principal author of the Declaration of Independence, and the third President of the United States. Are you looking for something?

* * *

>ask thomas about declaration of independence
Oh yes! You can have it! :)

>take declaration of independence
You already have that.

* * *

>n
(first opening Wooden door)
It seems to be locked.

>i
You are carrying:
  Declaration of Independence